b              
******  *****  
               
    **  *******
    *          
***** *******  
    *   *      
    *** *******
               
****     ****  
    ***        
    *   *******
      *        
****  ** ****  
    a          
